35  35  35  35  35  35  35  35  35  35  66  97  107 101 114 35  83  116 114 101 101 116 35  35  35  35  35  35  35  35  35  35
35  0   0   0   0   0   0   0   0   0   0   0   0   0   0   0   0   0   0   0   0   0   0   0   0   0   0   0   0   0   0   35
35  0   35  0   35  35  35  0   35  35  35  0   35  35  35  0   35  35  35  0   35  35  35  0   35  35  35  5   35  35  0   35                35  6   35  35  35  22  35  35  35  22  35  35  35  22  35  0   35  22  35  35  35  22  35  35  35  0   50  50  49  66  0   35                35  0   22  22  22  22  22  22  22  22  22  22  22  22  35  0   35  22  22  22  22  22  22  22  22  22  22  22  22  22  0   35
35  0   0   0   0   0   0   0   0   0   0   0   0   0   0   0   0   0   0   0   0   0   0   0   0   0   0   0   0   0   0   35
35  35  35  35  35  0   35  35  35  35  35  35  35  35  35  0   35  35  35  35  35  35  35  35  35  35  0   35  35  35  35  35 
35  15  15  15  35  0   35  15  15  15  15  15  15  15  35  0   35  15  15  15  15  15  15  15  15  35  0   35  15  15  15  35
35  15  15  15  35  0   35  15  15  15  15  15  15  35  0   0   0   35  15  15  15  15  15  15  15  35  0   35  15  15  15  35
35  35  35  35  35  0   35  15  15  15  15  15  35  0   0   4   0   0   35  15  15  15  15  15  15  35  0   35  35  35  35  35
0   0   0   0   35  0   35  15  15  15  15  35  35  0   35  35  35  0   35  35  15  15  15  15  15  35  0   35  0   0   0   0
0   0   0   0   35  6   35  15  15  15  35  0   35  0   0   35  0   0   35  0   35  15  15  15  15  35  0   35  0   0   0   0
0   0   0   0   35  0   35  15  15  15  15  35  35  35  0   0   0   35  35  35  15  15  15  15  15  35  0   35  0   0   0   0
0   0   0   0   35  0   0   0   0   0   0   0   0   0   35  0   35  0   0   0   0   0   0   0   0   0   0   35  0   0   0   0
0   0   0   0   35  35  35  35  35  35  35  35  35  0   0   2   0   0   35  35  35  35  35  35  35  35  35  35  0   0   0   0
0   0   0   0   0   0   0   0   0   0   0   0   0   35  35  35  35  35  0   0   0   0   0   0   0   0   0   0   0   0   0   0   