0  0  0  0  0  0  0  0  35 35 35 35 35 35 35 35 35 35 35 0  35 35 35 35 35 35 35 35 35 35 35 35
0  0  0  0  0  0  0  35 21 0  0  0  0  35 0  0  0  35 0  35 0  0  0  0  0  20 20 20 20 20 20 35
0  0  0  0  0  0  0  35 0  0  35 35 0  35 0  35 0  35 0  35 0  0  0  0  0  0  0  0  0  0  5  35
0  0  0  0  0  35 35 35 0  35 35 35 0  35 0  35 0  35 0  0  0  0  0  20 20 20 20 20 20 20 20 35
0  0  0  0  35 35 0  0  0  35 0  35 0  35 0  35 0  35 0  35 0  0  0  0  0  0  0  0  0  0  0  35
0  0  0  35 35 0  0  35 0  35 0  35 0  35 0  35 0  35 0  35 0  0  0  0  0  20 20 20 20 20 20 35
0  0  0  35 35 0  0  35 35 35 0  35 0  0  0  35 0  0  0  0  35 35 35 35 35 35 35 35 35 35 35 35
0  0  35 35 35 35 0  35 0  35 0  0  35 35 35 35 35 35 35 35 35 35 35 35 35 35 35 35 35 35 35 35
0  0  35 0  4  0  0  0  0  35 0  0  35 3 0 0 67 104 117 114 99 104 0 0 0 0 35 35 35 35 35 35 
0  0  35 0  0  0  0  35 0  35 0  35 35 3  0 0  43 43 43 43 43 43 0  0  0 35 35 0  0  0  0  0
35 35 35 35 35 35 35 35 0  0  35 35 35 3  0  0  0  0  0  0  0  0 0  0  35 35 35 0  0  0  0  0
35 35 0  0  0  0  0  0  0  0  0  0  35 3  0  0  0  0  0  0  0  2  0  35 35 0  0  0  0  0  0  0
35 35 0  0  0  0  0  0  0  0  0  0  35 3  0  0  0  0  0  0  0  0  0  35 35 0  0  0  0  0  0  0
35 35 0  0  0  0  0  0  0  0  0  0  35 3  0  0  0  0  0  0  0  0  35 35 35 0  0  0  0  0  0  0
35 35 6  0  0  0  0  0  0  0  0  0  0  0  0  0  0  0  0  0  0  0  35 35 35 0  0  0  0  0  0  0
35 35 35 35 35 35 35 35 35 35 35 35 35 35 35 35 35 35 35 35 35 35 35 35 35 0  0  0  0  0  0  0