35  35  35  35  0   86  105 99  116 111 114 105 97  0   67  111 110 99  101 114 116 0   72  97  108 108 0   35  35  35  35  35  
14  0   35  35  35  35  35  35  35  35  35  35  35  35  35  35  35  35  35  35  35  35  35  35  35  35  35  35  35  35  14  35  
35  0   0   0   0   0   0   0   0   0   0   0   5   0   0   0   0   0   0   0   0   0   0   0   0   0   0   0   35  35  35  0
35  35  35  35  35  35  35  35  35  35  35  35  0   83  116 97  103 101 35  35  35  35  35  0   35  35  35  35  35  35  0   0
0   35  53  0   20  35  0   0   0   0   0   35  0   0   0   0   0   0   35  0   0   0   0   0   35  20  0   54  35  0   0   0  
0   35  0   0   20  35  0   0   0   0   0   35  0   0   0   0   0   0   35  0   0   0   0   0   35  20  0   0   35  0   0   0
0   0   35  0   0   0   0   0   0   0   0   35  35  35  35  35  35  35  35  0   0   0   0   0   0   0   0   35  0   0   0   0
0   0   35  0   35  35  35  0   0   0   0   0   0   0   0   0   0   0   0   0   0   0   0   35  35  35  0   35  0   0   0   0
0   0   0   35  51  0   20  35  0   0   0   0   0   0   0   0   0   0   0   0   0   0   35  20  0   52  35  0   0   0   0   0 
0   0   0   35  0   0   20  35  0   0   0   0   20  20  20  20  20  20  0   0   0   0   35  20  0   0   35  0   0   0   0   0
0   0   0   0   35  0   0   0   0   0   0   0   0   0   0   0   0   0   0   0   0   0   0   0   0   35  0   0   0   0   0   0
0   0   0   0   35  0   35  35  35  0   0   0   20  20  20  20  20  20  0   0   0   35  35  35  0   35  0   0   0   0   0   0
0   0   0   0   0   35  49  0   20  35  0   0   0   0   0   0   0   0   0   0   35  20  0   50  35  0   0   0   0   0   0   0
0   0   0   0   0   35  0   0   20  35  0   0   20  20  20  20  20  20  0   0   35  20  0   0   35  0   0   0   0   0   0   0
0   0   0   0   0   0   35  0   0   0   0   0   0   0   0   2   0   0   0   0   0   0   0   35  0   0   0   0   0   0   0   0
0   0   0   0   0   0   0   35  35  35  35  35  35  35  35  35  35  35  35  35  35  35  35  0   0   0   0   0   0   0   0   0
