0   78  101 105 108 39  115 0   66  97  114 0   35  35  35  35  35  35  0   0   0   0   0   0   0   0   0   0   0   0   0   0
0   0   35  35  35  35  35  0   0   0   0   35  0   0   0   0   0   0   35  0   0   0   0   0   0   0   0   0   0   0   0   0
0   0   35  0   0   0   35  0   0   0   0   35  0   0   6   0   0   0   35  0   0   0   0   0   0   0   0   0   0   0   0   0
0   35  0   0   0   0   0   35  0   0   0   35  0   6   15  6   0   0   35  0   0   0   0   0   0   0   0   0   0   0   0   0
0   35  0   0   5   0   0   35  0   0   0   35  0   0   6   0   0   0   35  0   0   0   0   0   0   0   0   0   0   0   0   0
0   35  0   0   0   0   0   35  0   0   0   35  0   0   0   0   0   0   35  0   0   0   0   0   0   0   0   0   0   0   0   0
0   0   35  0   0   0   35  0   0   0   0   35  0   0   0   6   0   0   35  0   0   0   0   0   0   0   0   0   0   0   0   0
0   0   35  35  0   35  35  0   0   0   0   35  0   0   6   15  6   0   35  0   0   0   0   0   0   0   0   0   0   0   0   0
0   0   0   35  0   35  22  22  22  22  22  35  0   0   0   6   0   0   35  0   0   0   0   0   0   0   0   0   0   0   0   0
0   0   0   35  0   35  35  35  35  35  35  35  0   0   0   0   0   0   35  0   0   0   0   0   0   0   0   0   0   0   0   0
0   0   0   35  0   0   0   0   0   0   0   0   0   0   0   0   0   0   35  0   0   0   0   0   0   0   0   0   0   0   0   0
0   0   0   35  35  35  35  35  0   35  35  35  0   0   6   0   0   0   35  35  35  35  35  0   0   0   0   0   0   0   0   0
0   0   0   0   0   0   0   35  0   35  0   35  0   6   15  6   0   0   0   0   0   2   35  0   0   0   0   0   0   0   0   0
0   0   0   0   0   0   35  35  0   35  0   35  0   0   6   0   0   0   35  35  35  35  35  0   0   0   0   0   0   0   0   0
0   0   0   0   0   0   35  6   0   35  0   35  0   0   0   0   0   0   35  0   0   0   0   0   0   0   0   0   0   0   0   0
0   0   0   0   0   0   35  35  35  35  0   0   35  35  35  35  35  35  0   0   0   0   0   0   0   0   0   0   0   0   0   0