35 35 35 35 35 35 35 35 35 35 35 35 35 35 35 35 35 35 35 35 35 35 35 35 35 35 35 35 35 35 35 0
35 2  35 0  0  0  0  0  35 0  0  0  35 0  0  0  35 0  0  0  0  0  0  0  35 0  0  0  0  0  35 0
35 0  35 35 35 0  35 0  35 0  35 35 35 0  35 0  35 0  35 35 35 35 35 0  35 35 35 0  35 0  35 0
35 0  0  0  35 0  35 0  35 0  0  0  35 0  35 0  35 0  0  0  35 0  35 0  35 0  0  0  35 0  35 0
35 35 35 0  35 0  35 0  35 0  35 35 35 0  35 0  35 35 35 0  35 0  35 0  35 0  35 35 35 0  35 0
35 0  0  0  0  0  35 0  35 0  35 0  0  0  35 0  0  0  35 0  35 0  0  0  35 0  35 0  35 0  35 0
35 0  35 35 35 35 35 0  35 0  35 0  35 35 35 35 35 0  35 0  35 0  35 35 35 0  35 0  35 0  35 0
35 0  0  0  35 0  0  0  0  0  35 0  35 0  0  0  35 0  0  0  35 0  35 0  0  0  35 0  0  0  35 0
35 0  35 0  35 0  35 35 35 35 35 0  35 0  35 0  35 35 35 35 35 0  35 0  35 35 35 0  35 35 35 0
35 0  35 0  35 0  35 0  0  0  0  0  35 0  35 0  0  0  0  0  35 0  0  0  35 0  35 0  0  0  35 0
35 35 35 0  35 35 35 0  35 35 35 0  35 0  35 35 35 0  35 35 35 35 35 35 35 0  35 35 35 0  35 0
35 0  0  0  0  0  35 0  35 0  35 0  0  0  35 0  0  0  35 0  0  0  0  0  35 0  35 0  35 0  35 0
35 35 35 35 35 0  35 0  35 0  35 0  35 0  35 35 35 35 35 0  35 0  35 35 35 0  35 0  35 0  35 0
35 0  0  0  0  0  0  0  35 0  0  0  35 0  0  0  0  0  0  0  35 0  0  0  0  0  0  0  35 31 35 0
35 35 35 35 35 35 35 35 35 35 35 35 35 35 35 35 35 35 35 35 35 35 35 35 35 35 35 35 35 35 35 0
0  0  0  0  0  0  0  0  0  0  0  0  0  0  0  0  0  0  0  0  0  0  0  0  0  0  0  0  0  0  0  0  