0 0 0 0 0 0 0 0 0 0 0 0 0 35 35 35 35 35 35 35 35 35 35 35 35 35 35 35 35 35 35 35
0 0 0 0 0 0 0 0 0 35 0 0 0 0 0 0 0 0 0 0 0 0 0 0 0 0 0 0 0 0 0 35
0 0 0 0 0 0 0 35 0 0 0 0 0 0 0 0 0 0 0 0 0 0 0 0 0 0 0 0 0 0 0 35
0 0 0 0 0 0 0 0 0 35 0 0 0 0 0 0 0 0 0 0 0 0 0 0 0 0 0 0 0 0 0 35
0 0 0 0 0 0 35 35 35 35 0 0 0 0 0 0 0 0 0 0 0 0 0 0 0 0 0 0 0 0 0 35
0 0 0 0 0 0 35 0 0 35 0 35 0 0 0 0 0 0 0 0 0 0 0 20 0 0 0 0 0 0 0 35
0 0 0 0 0 0 0 0 0 35 0 35 0 0 0 0 0 0 0 0 0 0 0 0 0 0 0 0 0 0 0 35
0 0 0 0 0 0 0 0 0 0 0 0 35 35 35 35 35 35 35 35 35 35 35 35 35 0 0 0 0 0 0 35
0 0 0 0 0 0 0 35 35 35 0 0 35 0 0 0 0 0 0 0 0 0 21 21 35 35 35 35 35 35 35 35
0 0 0 0 0 0 0 0 0 6 0 35 35 0 0 0 0 0 0 0 0 22 0 0 35 0 0 0 0 0 0 0
35 35 35 35 35 35 6 35 35 35 35 35 35 0 0 0 0 0 0 0 0 0 0 0 35 0 0 0 0 0 0 0
35 0 0 0 0 0 0 0 0 0 0 0 35 6 0 0 0 0 0 0 0 23 0 35 0 0 0 0 0 0 0 0
35 0 0 0 0 0 0 0 0 0 0 0 0 0 0 0 0 0 0 0 0 0 0 35 0 0 0 0 0 0 0 0
35 0 0 0 0 3 0 3 0 0 0 0 0 0 0 0 0 0 0 0 0 0 0 35 0 0 0 0 0 0 0 0
35 0 0 0 0 0 0 0 0 0 0 0 6 0 0 0 6 0 0 6 0 0 35 0 0 0 0 0 0 0 0 0
35 35 35 35 35 35 35 35 35 35 35 35 35 35 35 35 35 35 35 35 35 35 0 0 0 0 0 0 0 0 0 0