0 0 0 0 0 0 0 0 0 0 0 0 0 35 35 35 35 35 35 35 35 35 35 35 35 35 35 35 35 35 35 35
0 0 0 0 0 0 0 0 0 35 0 0 0 0 0 0 0 0 0 0 0 0 0 0 0 0 0 0 0 0 0 35
0 0 0 0 0 0 0 35 0 0 0 0 0 0 0 0 0 0 0 0 0 0 0 0 0 0 0 0 0 0 0 35
0 0 0 0 0 0 0 0 0 35 0 0 0 0 0 0 0 0 0 0 0 0 0 0 0 0 0 0 0 0 0 35
0 0 0 0 0 0 35 35 35 35 0 0 0 0 0 0 0 0 0 0 0 0 0 0 0 0 0 0 0 0 0 35
0 0 0 0 0 0 35 0 0 35 0 35 0 0 0 0 0 0 0 0 0 0 0 20 0 0 0 0 0 0 3 35
0 0 0 0 0 0 0 0 0 35 0 35 0 0 0 0 0 0 0 0 0 0 0 0 0 0 0 0 0 0 0 35
0 0 0 0 35 0 0 0 0 0 0 0 35 35 35 35 35 35 35 35 35 35 35 35 35 0 0 0 0 0 0 35
0 0 0 0 0 0 0 0 0 0 0 0 22 0 0 0 0 0 0 0 0 0 0 21 35 35 35 35 35 35 35 35
0 0 0 0 0 0 0 0 0 0 0 0 22 0 0 0 0 0 0 0 0 22 0 0 35 0 0 0 0 0 0 0
35 35 35 35 35 35 35 35 22 35 35 35 35 0 0 0 0 0 0 0 0 0 0 0 35 0 0 0 0 0 0 0
35 0 0 0 0 0 0 0 0 0 0 0 35 6 0 0 0 0 0 0 0 23 0 35 0 0 0 0 0 0 0 0
35 0 0 0 0 0 0 0 0 0 0 0 0 0 0 0 0 0 0 0 0 0 0 35 0 0 0 0 0 0 0 0
35 0 0 0 0 22 0 22 0 0 6 0 0 0 0 0 0 0 0 0 0 0 0 35 0 0 0 0 0 0 0 0
35 0 0 0 0 0 0 0 0 0 0 0 22 0 0 0 22 0 0 22 0 0 35 0 0 0 0 0 0 0 0 0
35 35 35 35 35 35 35 35 35 35 35 35 35 35 35 35 35 35 35 35 35 35 0 0 0 0 0 0 0 0 0 0